
// ===================================================		   
// ====================== MAP 10 =====================
// ===================================================
		   
// définition des sprites		   
var MAP10 = ["chemin.png","decors2.png","JapaneseVillage.png","decors2.png","JapaneseVillage.png"];

// liste des personnages
var MAP10PERSO = [joueur,sheila,tony];

// liste des pancartes
var MAP10PANCARTE = [pancarte10];
	 
// fond			  
var MAP10A=[
[2, 2, 2, 2, 2, 2, 9, 10, 11,  2,  2,  2,  2,  2,  2, 2],
[2, 2, 2, 2, 2, 2, 9, 10, 11,  2,  2,  2,  2,  2,  2, 2],
[2, 2, 2, 2, 2, 2, 9, 10, 11,  2,  2,  2,  2,  2,  2, 2],
[2, 2, 2, 2, 2, 2, 9, 10, 11,  2,  2,  2,  2,  2,  2, 2],
[2, 2, 2, 2, 2, 2, 9, 10, 11,  2,  2,  2,  2,  2,  2, 2],
[2, 2, 2, 2, 2, 2, 9, 10, 11,  2,  2,  2,  2,  2,  1, 2],
[2, 2, 2, 2, 2, 2, 9, 10,  8,  6,  6,  6,  6,  6,  7, 2],
[2, 2, 2, 2, 5, 6, 4, 10, 10, 10, 10, 10, 12, 14, 15, 2],
[2, 2, 2, 2,13,16,10, 10, 12, 14, 14, 14, 15,  1,  2, 2],
[2, 2, 2, 2, 2,13,16, 10, 11,  2,  2,  2,  2,  2,  2, 2],
[2, 2, 2, 2, 2, 2, 9, 10, 11,  2,  2,  2,  2,  2,  2, 2],
[2, 2, 2, 2, 2, 2, 9, 10, 11,  2,  2,  2,  2,  2,  2, 2],
[2, 2, 2, 2, 2, 2, 9, 10, 11,  2,  2,  2,  2,  2,  2, 2],
[2, 2, 2, 2, 2, 2, 9, 10, 11,  2,  2,  2,  2,  2,  2, 2],
[2, 2, 2, 2, 2, 2, 9, 10, 11,  2,  2,  2,  2,  2,  2, 2]];
			
// terrain fond			
var MAP10B=[
[ 109, 110, 110, 110, 110, 108,   0,   0,   0, 106, 109, 110, 110, 110, 110, 110],
[ 167,   0,   0,   0,   0,   0,   0,   0,   0,   0, 167,   0,   0, 164,   0, 106],
[ 167,   0,   0,   0,   0,   0,   0,   0,   0, 182, 167, 162,   0,   0,   0, 106],
[ 167,   0, 106, 110, 110, 108,   0,   0,   0,   0,  93,   0,   0,   0,   0, 106],
[ 167,   0,   0,   0,   0, 167,   0,   0,   0, 106, 109, 109, 109, 108,   0, 106],
[ 167,   0,   0,   0,   0, 167,   0,   0,   0,   0, 182, 182, 182,   0,   0, 106],
[ 109, 109, 109, 108,   0, 182,   0,   0,   0,   0,   0,   0,   0,   0,   0, 106],
[ 109, 109, 109, 108,   0,   0,   0,   0,   0,   0,   0,   0,   0,   0,   0, 106],
[ 109, 109, 109, 108,   0,   0,   0,   0,   0,   0,   0,   0,   0,   0,   0, 106],
[ 109, 109, 109, 108,   0,   0,   0,   0,   0,   0,   0,   0,   0,   0,   0, 106],
[ 109, 110, 110, 108,   0, 167,   0,   0,   0, 106, 109, 109, 109, 109, 109, 109],
[ 167,   0,   0,   0,   0, 167,   0,   0,   0, 106, 109, 109, 109, 109, 109, 109],
[ 167,   0,   0,   0,   0, 167,   0,   0,   0, 106, 109, 109, 109, 109, 109, 109],
[  93,   0,   0,   0,   0, 182,   0,   0,   0, 106, 109, 109, 109, 109, 109, 109],
[ 110, 110, 110, 110, 110, 108,   0,   0,   0, 106, 110, 110, 110, 110, 110, 110]];

// terrain 1er plan
var MAP10D=[
[   0,   0,   0,   0,   0,   0,   0,   0,   0,   0,   0,   0,   0,   0,   0,  90],
[   0,   0,   0,   0,   0,   0,   0,   0,   0, 166,   0,   0,   0,   0,   0,  90],
[   0,   0,  90,  94,  94,  92,   0,   0,   0,   0,   0,   0,   0,   0,   0,  90],
[   0,   0,   0,   0,   0, 166,   0,   0,   0,  90,   0,  94,  94,  92,   0,  90],
[   0,   0,   0,   0,   0,   0,   0,   0,   0,   0,   0,   0,   0,   0,   0,  90],
[  94,  94,  94,  92,   0,   0,   0,   0,   0,   0,   0,   0,   0,   0,   0,  90],
[  94,  94,  94,  92,   0,   0,   0,   0,   0,   0,   0,   0,   0,   0,   0,  90],
[  94,  94,  94,  92,   0,   0,   0,   0,   0,   0,   0,   0,   0,   0,   0,  90],
[  94,  94,  94,  92,   0,   0,   0,   0,   0,   0,   0,   0,   0,   0,   0,  90],
[  94,  94,  94,  92,   0, 166,   0,   0,   0,  90,  94,  94,  94,  94,  94,  94],
[   0,   0,   0,   0,   0,   0,   0,   0,   0,  90,  94,  94,  94,  94,  94,  94],
[   0,   0,   0,   0,   0,   0,   0,   0,   0,  90,  94,  94,  94,  94,  94,  94],
[   0,   0,   0,   0,   0,   0,   0,   0,   0,  90,  94,  94,  94,  94,  94,  94],
[   0,  94,  94,  94,  94,  92,   0,   0,   0,  90,  94,  94,  94,  94,  94,  94],
[   0,   0,   0,   0,   0,   0,   0,   0,   0,   0,   0,   0,   0,   0,   0,   0]];

//décor fond			
var MAP10C=[
[   0,   0,   0,   0,   0,   0,   0,   0,   0,   0,   0,   0,   0,   0,   0,   0],
[   0,   0,   0,   0,   0,   0,   0,   0,   0,   0,   0,   0,   0,   0,   0,   0],
[   0,   0,   0,   0,   0,   0,   0,   0,   0,   0,   0,   0,   0,   0,   0,   0],
[   0,   0,   0,   0,   0,   0,   0,   0,   0,   0,   0,   0,   0,   0,   0,   0],
[   0,   0,   0,   0,   0,   0,   0,   0,   0,   0,   0,   0,   0,   0,   0,   0],
[   0,   0,   0,   0,   0,   0,   0,   0,   0,   0,   0,   0,   0,   0,   0,   0],
[   0,   0,   0,   0,   0,   0,   0,   0,   0,   0,   0,   0,   0,   0,   0,   0],
[   0,   0,   0,   0,   0,   0,   0,   0,   0,   0,   0,   0,   0,   0,   0,   0],
[   0,   0,   0,   0,   0,   0,   0,   0,   0,   0,   0,   0,   0,   0,   0,   0],
[   0,   0,   0,   0,   0,   0,   0,   0,   0,   0,   0,   0,   0,   0,   0,   0],
[   0,   0,   0,   0,   0,   0,   0,   0,   0,   0,   0,   0,   0,   0,   0,   0],
[   0,   0,   0,   0,   0,   0,   0,   0,   0,   0,   0,   0,   0,   0,   0,   0],
[   0,   0,   0,   0,   0,   0,   0,   0,   0,   0,   0,   0,   0,   0,   0,   0],
[   0,   0,   0,   0,   0,   0,   0,   0,   0,   0,   0,   0,   0,   0,   0,   0],
[   0,   0,   0,   0,   0,   0,   0,   0,   0,   0,   0,   0,   0,   0,   0,   0]];

// decor 1er plan		
var MAP10E=[
[   0,   0,   0,   0,   0,   0,   0,   0,   0,   0,   0,   0,   0,   0,   0,   0],
[   0,   0,   0,   0,   0,   0,   0,   0,   0,   0,   0,   0,   0,   0,   0,   0],
[   0,   0,   0,   0,   0,   0,   0,   0,   0,   0,   0,   0,   0,   0,   0,   0],
[   0,   0,   0,   0,   0,   0,   0,   0,   0,   0,   0,   0,   0,   0,   0,   0],
[   0,   0,   0,   0,   0,   0,   0,   0,   0,   0,   0,   0,   0,   0,   0,   0],
[   0,   0,   0,   0,   0,   0,   0,   0,   0,   0,   0,   0,   0,   0,   0,   0],
[   0,   0,   0,   0,   0,   0,   0,   0,   0,   0,   0,   0,   0,   0,   0,   0],
[   0,   0,   0,   0,   0,   0,   0,   0,   0,   0,   0,   0,   0,   0,   0,   0],
[   0,   0,   0,   0,   0,   0,   0,   0,   0,   0,   0,   0,   0,   0,   0,   0],
[   0,   0,   0,   0,   0,   0,   0,   0,   0,   0,   0,   0,   0,   0,   0,   0],
[   0,   0,   0,   0,   0,   0,   0,   0,   0,   0,   0,   0,   0,   0,   0,   0],
[   0,   0,   0,   0,   0,   0,   0,   0,   0,   0,   0,   0,   0,   0,   0,   0],
[   0,   0,   0,   0,   0,   0,   0,   0,   0,   0,   0, 163,   0,   0,   0,   0],
[   0,   0,   0,   0,   0,   0,   0,   0,   0,   0, 170, 171, 172,   0,   0,   0],
[   0,   0,   0,   0,   0,   0,   0,   0,   0, 177, 186, 187, 188, 181,   0,   0]];		


// collision	
var MAP10F=[
[   1,   1,   1,   1,   1,   1,   "01/06/13/3",   "01/07/13/3",   "01/08/13/3",   1,   1,   1,   1,   1,   1,   1],
[   1,   0,   0,   0,   0,   0,   0,   0,   0,   0,   1,   0,   0,   0,   0,   1],
[   1,   0,   0,   0,   0,   0,   0,   0,   0,   1,   1,   0,   0,   0,   0,   1],
[   1,   0,   1,   1,   1,   1,   0,   0,   0,   0,   1,   0,   0,   0,   0,   1],
[   1,   0,   0,   0,   0,   1,   0,   0,   0,   1,   1,   1,   1,   1,   0,   1],
[   1,   0,   0,   0,   0,   1,   0,   0,   0,   1,   1,   1,   1,   0,   0,   1],
[   1,   1,   1,   0,   0,   1,   0,   0,   0,   0,   0,   0,   0,   0,   0,   1],
[   1,   1,   1,   0,   0,   0,   0,   0,   0,   0,   0,   0,   0,   0,   0,   1],
[   1,   1,   1,   0,   0,   0,   0,   0,   0,   0,   0,   0,   0,   0,   0,   1],
[   1,   1,   1,   0,   0,   0,   0,   0,   0,   1,   1,   1,   1,   1,   1,   1],
[   1,   1,   1,   0,   0,   1,   0,   0,   0,   1,   1,   1,   1,   1,   1,   1],
[   1,   0,   0,   0,   0,   1,   0,   0,   0,   1,   1,   1,   1,   1,   1,   1],
[   1,   0,   0,   0,   0,   1,   0,   0,   0,   1,   1,   1,   1,   1,   1,   1],
[   1,   0,   0,   0,   0,   1,   0,   0,   0,   1,   1,   1,   1,   1,   1,   1],
[   1,   1,   1,   1,   1,   1,   "08/06/01/0",   "08/07/01/0",   "08/08/01/0",   1,   1,   1,   1,   1,   1,   1]];

