// ===================================================		   
// ====================== MAP 08 =====================
// ===================================================

// définition des sprites
MAP08 = ["chemin.png","JapaneseVillage.png","JapaneseVillage.png","decors2.png","JapaneseVillage.png"];

// liste des personnages
var MAP08PERSO = [joueur];

// liste des pancartes
var MAP08PANCARTE = [pancarte8];
			 
// fond			  
var MAP08A=[
[2, 2, 2, 2, 2, 2, 2,10, 2,  2,  2,  2,  2,  2,  2, 2, 2,  2,  2,  2,  2,  2,  2, 2, 2, 2],
[2, 2, 2, 2, 2, 2, 2,10, 2,  2,  2,  2,  2,  2,  2, 2, 2,  2,  2,  2,  2,  2,  2, 2, 2, 2],
[2, 2,10,10,10,10,10,10,10, 10,  2,  2,  2,  2,  2, 2, 2,  2, 10, 10,  2,  2,  2, 2, 2, 2],
[2, 2,10, 2, 2, 2, 2, 2, 2, 10,  2,  2,  2,  2,  2, 2, 2,  2, 10, 10,  2,  2,  2,10, 2, 2],
[2, 2,10, 2, 2, 2, 2, 2, 2, 10,  2,  2,  2,  2,  2, 2, 2,  2,  2, 10, 2,  2,  2, 10, 2, 2],
[2, 2,10, 2, 2, 2, 2, 2, 2, 10,  2,  2,  2,  2,  2, 2, 2,  2,  2, 10,  2,  2,  2,10, 2, 2],
[2, 2,10,10,10,10,10,2 , 2, 10,  2,  2,  2,  2,  2, 2, 2,  2,  2, 10, 10, 10, 10,10, 2, 2],
[2, 2, 2, 2, 2, 2,10, 2, 2, 10,  2,  2,  2,  2,  2, 2, 2,  2,  2,  2,  2,  2,  2,10, 2, 2],
[2, 2, 2, 2, 2, 2,10, 2, 2, 10, 10, 10, 10, 10,  2, 2, 2,  2,  2,  2,  2,  2,  2,10, 2, 2],
[2, 2, 2, 2, 2, 2,10, 2, 2,  2,  2,  2,  2, 10, 10,10, 2,  2,  2,  2,  2,  2,  2,10, 2, 2],
[2, 2, 2, 2, 2, 2,10, 2, 2,  2,  2,  2,  2,  2,  2,10,10,  2,  2,  2,  2,  2,  2,10, 2, 2],
[2, 2, 2, 2, 2, 2,10, 2, 2,  2,  2,  2,  2,  2,  2, 2,10,  2,  2,  2,  2,  2,  2,10, 2, 2],
[2, 2, 2, 2, 2, 2,10, 2, 2,  2,  2,  2,  2,  2,  2, 2,10,  2,  2,  2,  2,  2,  2,10, 2, 2],
[2, 2, 2, 2, 2,10,10,10, 2,  2,  2,  2,  2,  2,  2, 2,10,  2,  2,  2,  2,  2,  2,10, 2, 2],
[2, 2, 2, 2, 2, 2,10, 2, 2,  2,  2,  2,  2,  2,  2, 2,10,  2,  2,  2,  2,  2,  2,10, 2, 2],
[2, 2, 2, 2, 2, 2,10, 2, 2,  2,  2,  2,  2,  2,  2, 2,10, 10, 10, 10, 10, 10, 10,10,10, 2],
[2, 2, 2, 2,10,10,10,10,10, 10,  2,  2,  2,  2,  2, 2,10,  2,  2,  2,  2,  2,  2, 2, 2, 2],
[2, 2, 2, 2, 2, 2, 2, 2, 2,  2,  2,  2,  2,  2,  2, 2,10,  2,  2,  2,  2,  2,  2, 2, 2, 2]];

// terrain fond			
var MAP08B=[
[   0,   0,   0,   0,   0,   0,   0,   0,   0,   0,   0,   0,   0,   0,   0,   0,   0,   0,   0,   0,   0,   0,   0,   0,   0,   0],
[   0,   0,   0,   0,   0,   0,   0,   0,   0,   0,   0,   0,   0,   0,   0,   0,   0,   0,   0,   0,   0,   0,   0,   0,   0,   0],
[   0,   0,   0,   0,   0,   0,   0,   0,   0,   0,   0,   0,   0,   0,   0,   0,   0,   0,   0,   0,   0,   0,   0,   0,   0,   0],
[   0,   0,   0,   0,   0,   0,   0,   0,   0,   0,   0,   0,   0,   0,   0,   0,   0,   0,   0,   0,   0,   0,   0,   0,   0,   0],
[   0,   0,   0,   0,   0,   0,   0,   0,   0,   0,   0,   0,   0,   0,   0,   0,   0,   0,   0,   0,   0,   0,   0,   0,   0,   0],
[   0,   0,   0,   0,   0,   0,   0,   0,   0,   0,   0,   0,   0,   0,   0,   0,   0,   0,   0,   0,   0,   0,   0,   0,   0,   0],
[   0,   0,   0,   0,   0,   0,   0,   0,   0,   0,   0,   0,   0,   0,   0,   0,   0,   0,   0,   0,   0,   0,   0,   0,   0,   0],
[   0,   0,   0,   0,   0,   0,   0,   0,   0,   0,   0,   0,   0,   0,   0,   0,   0,   0,   0,   0,   0,   0,   0,   0,   0,   0],
[   0,   0,   0,   0,   0,   0,   0,   0,   0,   0,   0,   0,   0,   0,   0,   0,   0,   0,   0,   0,   0,   0,   0,   0,   0,   0],
[   0,   0,   0,   0,   0,   0,   0,   0,   0,   0,   0,   0,   0,   0,   0,   0,   0,   0,   0,   0,   0,   0,   0,   0,   0,   0],
[   0,   0,   0,   0,   0,   0,   0,   0,   0,   0,   0,   0,   0,   0,   0,   0,   0,   0,   0,   0,   0,   0,   0,   0,   0,   0],
[   0,   0,   0,   0,   0,   0,   0,   0,   0,   0,   0,   0,   0,   0,   0,   0,   0,   0,   0,   0,   0,   0,   0,   0,   0,   0],
[   0,   0,   0,   0,   0,   0,   0,   0,   0,   0,   0,   0,   0,   0,   0,   0,   0,   0,   0,   0,   0,   0,   0,   0,   0,   0],
[   0,   0,   0,   0,   0,   0,   0,   0,   0,   0,   0,   0,   0,   0,   0,   0,   0,   0,   0,   0,   0,   0,   0,   0,   0,   0],
[   0,   0,   0,   0,   0,   0,   0,   0,   0,   0,   0,   0,   0,   0,   0,   0,   0,   0,   0,   0,   0,   0,   0,   0,   0,   0],
[   0,   0,   0,   0,   0,   0,   0,   0,   0,   0,   0,   0,   0,   0,   0,   0,   0,   0,   0,   0,   0,   0,   0,   0,   0,   0],
[   0,   0,   0,   0,   0,   0,   0,   0,   0,   0,   0,   0,   0,   0,   0,   0,   0,   0,   0,   0,   0,   0,   0,   0,   0,   0],
[   0,   0,   0,   0,   0,   0,   0,   0,   0,   0,   0,   0,   0,   0,   0,   0,   0,   0,   0,   0,   0,   0,   0,   0,   0,   0]];

// terrain 1er plan
var MAP08D=[
[   0,   0,   0,   0,   0,   0,   0,   0,   0,   0,   0,   0,   0,   0,   0,   0,   0,   0,   0,   0,   0,   0,   0,   0,   0,   0],
[   0,   0,   0,   0,   0,   0,   0,   0,   0,   0,   0,   0,   0,   0,   0,   0,   0,   0,   0,   0,   0,   0,   0,   0,   0,   0],
[   0,   0,   0,   0,   0,   0,   0,   0,   0,   0,   0,   0,   0,   0,   0,   0,  18,   0,   0,   0,   0,   0,   0,   0,   0,   0],
[   0,   0,   0,   0,   0,   0,   0,   0,   0,   0,   0,   0,   0,   0,   0,   0,   0,   0,   0,   0,   0,   0,   0,   0,   0,   0],
[   0,   0,   0,   0,   0,   0,   0,   0,   0,   0,   0,   0,   0,   0,   0,   0,   0,   0,   0,   0,   0,   0,   0,  17,   0,   0],
[   0,   0,   0,   0,   0,   0,   0,   0,   0,   0,   0,   0,   0,   0,   0,   0,   0,   0,   0,   0,   0,   0,   0,   0,   0,   0],
[   0,   0,   0,   0,   0,   0,   0,   0,   0,   0,   0,   0,   0,   0,   0,   0,   0,   0,   0,   0,   0,   0,   0,   0,   0,   0],
[   0,   0,   0,   0,   0,   0,   0,   0,   0,   0,   0,   0,   0,   0,   0,   0,   0,   0,   0,   0,   0,   0,   0,   0,   0,   0],
[   0,   0,   0,   0,   0,   0,   0,   0,   0,   0,   0,   0,   0,   0,   0,   0,   0,   0,   0,   0,   0,   0,   0,   0,   0,   0],
[   0,   0,   0,   0,   0,   0,   0,   0,   0,   0,   0,   0,   0,   0,   0,   0,   0,   0,   0,   0,   0,   0,   0,   0,   0,   0],
[   0,   0,   0,   0,   0,   0,   0,   0,   0,   0,   0,   0,   0,   0,   0,   0,   0,   0,   0,   0,   0,   0,   0,   0,   0,   0],
[   0,   0,   0,   0,   0,   0,   0,   0,   0,   0,   0,   0,   0,   0,   0,   0,   0,   0,   0,   0,   0,   0,   0,   0,   0,   0],
[   0,   0,   0,   0,   0,   0,   0,   0,   0,   0,   0,   0,   0,   0,   0,   0,   0,   0,   0,   0,   0,   0,   0,   0,   0,   0],
[   0,   0,   0,   0,   0,   0,   0,   0,   0,   2,   0,   0,   0,   0,   0,   0,   0,   0,   0,   0,   0,   0,   0,   0,   0,   0],
[   0,   0,   0,   0,   0,   0,   0,   0,   0,   0,   0,   0,   0,   0,   0,   0,   0,   0,   0,   0,   0,   0,   0,   0,   0,   0],
[   0,   0,   0,   0,   0,   0,   0,   0,   0,   0,   0,   0,   0,   0,   0,   0,   0,   0,   0,   0,   0,   0,   0,   0,   0,   0],
[   0,   0,   0,   0,   0,   0,   0,   0,   0,   0,   0,   0,  19,   0,   0,   0,   0,   0,   0,   0,   0,   0,   0,   0,   0,   0],
[   0,   0,   0,   0,   0,   0,   0,   0,   0,   0,   0,   0,   0,   0,   0,   0,   0,   0,   0,   0,   0,   0,   0,   0,   0,   0]];

//décor fond			
var MAP08C=[
[   0,   0,   0,   0,   0,   0,   0,   0,   0,   0,   0,  40,   0, 193, 194, 195, 196, 197,   0,   0,   0,   0,   0,   0,   0,   0],
[   0,   0,   0,   0,   0,   0,   0,   0,   0,   0,   0,  40,   0, 201, 202, 203, 204, 205,   0,   0,   0,   0,   0,   0,   0,   0],
[   0,   0,   0,   0,   0,   0,   0,   0,   0,   0,   0,  40,   0, 209, 279, 279, 279, 213,   0,   0, 193, 194, 195, 196, 197,   0],
[   0,   0,   0,  40,  40,  40,  40,  40,  40,   0,   0,  40,   0, 217, 218, 218, 218, 221,   0,   0, 201, 202, 203, 204, 205,   0],
[   0,   0,   0,   0,   0,   0,   0,   0,  40,   0,   0,  40,   0,   0,   0,   0,   0,   0,   0,   0, 209, 279, 279, 279, 213,   0],
[   0,   0,   0,   0,   0,   0,   0,   0,  40,   0,   0,  40,   0,   0,   0,   0,   0,   0,   0,   0, 217, 218, 218, 218, 221,   0],
[   0,   0,   0,   0,   0,   0,   0,   0,  40,   0,   0,  40,  40,  40,  40,  40,  40,  40,   0,   0,   0,   0,   0,   0,   0,   0],
[   0,   0,   0,   0,   0,   0,   0,   0,  40,   0,   0,   0,   0,   0,   0,   0,   0,  40,   0,   0,   0,   0,   0,   0,   0,   0],
[   0,   0,   0,   0,   0,   0,   0,   0,  40,   0,   0,   0,   0,   0,   0,   0,   0,  40,  40,  40,  40,  40,  40,   0,   0,   0],
[   0,   0,   0,   0,   0,   0,   0,   0,  40,  40,   0,  40,  40,   0,   0,   0,   0,   0,   0,   0,   0,   0,  40,   0,   0,   0],
[   0,   0,   0,   0,   0,   0,   0,   0,   0,   0,   0,   0,  40,  40,  40,   0,   0,   0,   0,   0,   0,   0,  40,   0,   0,   0],
[ 190, 191, 191, 191, 192,   0,   0,   0, 193, 194, 195, 196, 197,   0,  40,  40,   0,   0,   0,   0,   0,   0,  40,   0,   0,   0],
[ 198, 199, 199, 199, 200,   0,   0,   0, 201, 202, 203, 204, 205,   0,   0,  40,   0,   0,   0,   0,   0,   0,  40,   0,   0,   0],
[ 206, 207, 207, 207, 208,   0,   0,   0, 209, 279, 279, 279, 213,   0,   0,  40,   0,   0,   0,   0,   0,   0,  40,   0,   0,   0],
[ 190, 191, 191, 192, 216,   0,   0,   0, 217, 218, 193, 194, 195, 196, 197,  40,   0,   0,   0,   0,   0,   0,   0,   0,   0,   0],
[ 198, 199, 199, 200,   0,   0,   0,   0,   0,   0, 201, 202, 203, 204, 205,  40,   0,   0,   0,   0,   0,   0,   0,   0,   0,   0],
[ 206, 207, 207, 208,   0,   0,   0,   0,   0,   0, 209, 279, 279, 279, 213,  40,   0,   0,   0,   0,   0,   0,   0,   0,   0,   0],
[ 214, 215, 215, 216,   0,   0,   0,   0,   0,   0, 217, 218, 218, 218, 221,  40,   0,   0,   0,   0,   0,   0,   0,   0,   0,   0]];

// decor 1er plan		
var MAP08E=[
[   0,   0,   0,   0,   0,   0,   0,   0,   0,   0,   0,   0,   0,   0,   0,   0,   0,   0,   0,   0,   0, 170, 171, 172,   0,   0],
[   0,   0,   0,   0,   0,   0,   0,   0,   0,   0,   0,   0,   0,   0,   0,   0,   0,   0,   0,   0, 177, 186, 187, 188, 181,   0],
[   0,   0,   0,   0,   0,   0,   0,   0,   0,   0,   0,   0,   0,   0,   0,   0,   0,   0,   0,   0,   0,   0,   0,   0,   0,   0],
[   0,   0,   0,   0,   0,   0,   0,   0,   0,   0,   0,   0,   0,   0,   0,   0,   0,   0,   0,   0,   0,   0,   0,   0,   0,   0],
[   0,   0,   0,   0,   0,   0,   0,   0,   0,   0,   0,   0,   0,   0,   0,   0,   0,   0,   0,   0,   0,   0,   0,   0,   0,   0],
[   0,   0,   0,   0,   0,   0,   0,   0,   0,   0,   0,   0,   0,   0,   0,   0,   0,   0,   0,   0,   0,   0,   0,   0,   0,   0],
[   0,   0,   0,   0,   0,   0,   0,   0,   0,   0,   0,   0,   0,   0,   0,   0,   0,   0,   0,   0,   0,   0,   0,   0,   0,   0],
[   0,   0,   0,   0,   0,   0,   0,   0,   0,   0,   0,   0,   0,   0,   0,   0,   0,   0,   0,   0,   0,   0,   0,   0,   0,   0],
[   0,   0,   0,   0,   0,   0,   0,   0,   0,   0, 163,   0,   0,   0,   0,   0,   0,   0,   0,   0,   0,   0,   0,   0,   0,   0],
[ 166, 167, 167, 167, 168,   0,   0,   0,   0, 170, 171, 172,   0,   0,   0,   0,   0,   0,   0,   0,   0,   0,   0,   0,   0,   0],
[ 182, 183, 183, 183, 184,   0,   0,   0, 177, 186, 187, 188, 181,   0,   0,   0,   0,   0,   0,   0,   0,   0,   0,   0,   0,   0],
[   0,   0,   0,   0,   0,   0,   0,   0,   0,   0,   0,   0, 163,   0,   0,   0,   0,   0,   0,   0,   0,   0,   0,   0,   0,   0],
[ 166, 167, 167, 168,   0,   0,   0,   0,   0,   0,   0, 170, 171, 172,   0,   0,   0,   0,   0,   0,   0,   0,   0,   0,   0,   0],
[ 182, 183, 183, 184,   0,   0,   0,   0,   0,   0, 177, 186, 187, 188, 181,   0,   0,   0,   0,   0,   0,   0,   0,   0,   0,   0],
[   0,   0,   0,   0,   0,   0,   0,   0,   0,   0,   0,   0,   0,   0,   0,   0,   0,   0,   0,   0,   0,   0,   0,   0,   0,   0],
[   0,   0,   0,   0,   0,   0,   0,   0,   0,   0,   0,   0,   0,   0,   0,   0,   0,   0,   0,   0,   0,   0,   0,   0,   0,   0],
[   0,   0,   0,   0,   0,   0,   0,   0,   0,   0,   0,   0,   0, 107,   0,   0,   0,   0,   0,   0,   0,   0,   0,   0,   0,   0],
[   0,   0,   0,   0,   0,   0,   0,   0,   0,   0,   0,   0,   0,   0,   0,   0,   0,   0,   0,   0,   0,   0,   0,   0,   0,   0]];		

// collision			
var MAP08F=[
[   0,   0,   0,   0,   0,   0,   "10/06/13/3",   "10/07/13/3",   "10/08/13/3",   0,   0,   0,   0,   0,   0,   0,   0,   0,   0,   0,   0,   0,   0,   0,   0,   0],
[   0,   0,   0,   0,   0,   0,   0,   0,   0,   0,   0,   0,   0,   0,   0,   0,   0,   0,   0,   0,   0,   0,   0,   0,   0,   0],
[   0,   0,   0,   0,   0,   0,   0,   0,   0,   0,   0,   0,   0,   0,   0,   0,   0,   0,   0,   0,   0,   0,   0,   0,   0,   0],
[   0,   0,   0,   0,   0,   0,   0,   0,   0,   0,   0,   0,   0,   0,   0,   0,   0,   0,   0,   0,   0,   0,   0,   0,   0,   0],
[   0,   0,   0,   0,   0,   0,   0,   0,   0,   0,   0,   0,   0,   0,   0,   0,   0,   0,   0,   0,   0,   0,   0,   0,   0,   0],
[   "09/14/06/1",   0,   0,   0,   0,   0,   0,   0,   0,   0,   0,   0,   0,   0,   0,   0,   0,   0,   0,   0,   0,   0,   0,   0,   0,   0],
[   "09/14/07/1",   0,   0,   0,   0,   0,   0,   0,   0,   0,   0,   0,   0,   0,   0,   0,   0,   0,   0,   0,   0,   0,   0,   0,   0,   0],
[   "09/14/08/1",   0,   0,   0,   0,   0,   0,   0,   0,   0,   0,   0,   0,   0,   0,   0,   0,   0,   0,   0,   0,   0,   0,   0,   0,   0],
[   0,   0,   0,   0,   0,   0,   0,   0,   0,   0,   0,   0,   0,   0,   0,   0,   0,   0,   0,   0,   0,   0,   0,   0,   0,   0],
[   0,   0,   0,   0,   0,   0,   0,   0,   0,   0,   0,   0,   0,   0,   0,   0,   0,   0,   0,   0,   0,   0,   0,   0,   0,   0],
[   0,   0,   0,   0,   0,   0,   0,   0,   0,   0,   0,   0,   0,   0,   0,   0,   0,   0,   0,   0,   0,   0,   0,   0,   0,   0],
[   0,   0,   0,   0,   0,   0,   0,   0,   0,   0,   0,   0,   0,   0,   0,   0,   0,   0,   0,   0,   0,   0,   0,   0,   0,   0],
[   0,   0,   0,   0,   0,   0,   0,   0,   0,   0,   0,   0,   0,   0,   0,   0,   0,   0,   0,   0,   0,   0,   0,   0,   0,   0],
[   0,   0,   0,   0,   0,   0,   0,   0,   0,   0,   0,   0,   0,   0,   0,   0,   0,   0,   0,   0,   0,   0,   0,   0,   0,   0],
[   0,   0,   0,   0,   0,   0,   0,   0,   0,   0,   0,   0,   0,   0,   0,   0,   0,   0,   0,   0,   0,   0,   0,   0,   0,   0],
[   0,   0,   0,   0,   0,   0,   0,   0,   0,   0,   0,   0,   0,   0,   0,   0,   0,   0,   0,   0,   0,   0,   0,   0,   0,   0],
[   0,   0,   0,   0,   0,   0,   0,   0,   0,   0,   0,   0,   0,   0,   0,   0,   0,   0,   0,   0,   0,   0,   0,   0,   0,   0],
[   0,   0,   0,   0,   0,   0,   0,   0,   0,   0,   0,   0,   0,   0,   0,   "07/06/01/0",   "07/07/01/0",   "07/08/01/0",   0,   0,   0,   0,   0,   0,   0,   0]];


